00 04 04 04 04 04 04 04 04 04 04 04 04 08 04 09 04 04 04 04 04 04 04 04 04 04 04 04 01
02 -1 -1 -1 -1 -1 -1 -1 -1 -1 -1 -1 -1 12 -1 13 -1 -1 -1 -1 -1 -1 -1 -1 -1 -1 -1 -1 03
02 -1 06 15 15 07 -1 06 15 15 15 07 -1 12 -1 13 -1 06 15 15 15 07 -1 06 15 15 07 -1 03
02 -1 12 -1 -1 13 -1 12 -1 -1 -1 13 -1 12 -1 13 -1 12 -1 -1 -1 13 -1 12 -1 -1 13 -1 03
02 -1 16 14 14 17 -1 16 14 14 14 17 -1 16 14 17 -1 16 14 14 14 17 -1 16 14 14 17 -1 03