-9 -9 -9 -9 -9 -9 -9 -9 -9 -9 -9 -9 -9 -9 -9 -9 -9 -9 -9 -9 -9 -9 -9 -9 -9 -9 -9 -9 -9 
-9 -9 -9 -9 -9 -9 -9 -9 -9 -9 -9 -9 -9 -9 -9 -9 -9 -9 -9 -9 -9 -9 -9 -9 -9 -9 -9 -9 -9 
-9 -9 -9 -9 -9 -9 -9 -9 -9 -9 -9 -9 -9 -9 -9 -9 -9 -9 -9 -9 -9 -9 -9 -9 -9 -9 -9 -9 -9 
-9 -9 -9 -9 -9 -9 -9 -9 -9 -9 -9 -9 -9 -9 -9 -9 -9 -9 -9 -9 -9 -9 -9 -9 -9 -9 -9 -9 -9 
00 04 04 04 04 04 04 04 04 04 04 04 04 08 24 09 04 04 04 04 04 04 04 04 04 04 04 04 01
02 -3 -2 -2 -2 -2 -2 -2 -2 -2 -2 -2 -2 12 -9 13 -2 -2 -2 -2 -2 -2 -2 -2 -2 -2 -2 -3 03
02 -2 06 15 15 07 -2 06 15 15 15 07 -2 12 -9 13 -2 06 15 15 15 07 -2 06 15 15 07 -2 03
02 -2 12 -9 -9 13 -2 12 -9 -9 -9 13 -2 12 -9 13 -2 12 -9 -9 -9 13 -2 12 -9 -9 13 -2 03
02 -2 16 14 14 17 -2 16 14 14 14 17 -2 16 14 17 -2 16 14 14 14 17 -2 16 14 14 17 -2 03
02 -2 -2 -2 -2 -2 -2 -2 -2 -2 -2 -2 -2 -2 -2 -2 -2 -2 -2 -2 -2 -2 -2 -2 -2 -2 -2 -2 03
02 -2 06 15 15 07 -2 06 07 -2 06 15 15 15 15 15 15 15 07 -2 06 07 -2 06 15 15 07 -2 03
02 -2 16 14 14 17 -2 12 13 -2 16 14 14 07 -9 06 14 14 17 -2 12 13 -2 16 14 14 17 -2 03
02 -2 -2 -2 -2 -2 -2 12 13 -2 -2 -2 -2 12 -9 13 -2 -2 -2 -2 12 13 -2 -2 -2 -2 -2 -2 03
10 05 05 05 05 23 -2 12 16 15 15 07 -2 12 -9 13 -2 06 15 15 17 13 -2 22 05 05 05 05 11
-9 -9 -9 -9 -9 02 -2 12 06 14 14 17 -2 16 14 17 -2 16 14 14 07 13 -2 03 -9 -9 -9 -9 -9
-9 -9 -9 -9 -9 02 -2 12 13 -2 -2 -2 -2 -2 -2 -2 -2 -2 -2 -2 12 13 -2 03 -9 -9 -9 -9 -9
-9 -9 -9 -9 -9 02 -2 12 13 -2 22 05 05 -9 -9 -9 05 05 23 -2 12 13 -2 03 -9 -9 -9 -9 -9
04 04 04 04 04 33 -2 16 17 -2 03 -9 -9 -9 -9 -9 -9 -9 02 -2 16 17 -2 32 04 04 04 04 04
-9 -9 -9 -9 -9 -9 -2 -2 -2 -2 03 -9 -9 -9 -9 -9 -9 -9 02 -2 -2 -2 -2 -9 -9 -9 -9 -9 -9
05 05 05 05 05 23 -2 06 07 -2 03 -9 -9 -9 -9 -9 -9 -9 02 -2 06 07 -2 22 05 05 05 05 05
-9 -9 -9 -9 -9 02 -2 12 13 -2 32 04 04 04 04 04 04 04 33 -2 12 13 -2 03 -9 -9 -9 -9 -9
-9 -9 -9 -9 -9 02 -2 12 13 -2 -2 -2 -2 -2 -6 -2 -2 -2 -2 -2 12 13 -2 03 -9 -9 -9 -9 -9
-9 -9 -9 -9 -9 02 -2 12 13 -2 06 15 15 15 15 15 15 15 07 -2 12 13 -2 03 -9 -9 -9 -9 -9
00 04 04 04 04 33 -2 16 17 -2 16 14 14 07 -9 06 14 14 17 -2 16 17 -2 32 04 04 04 04 01
02 -2 -2 -2 -2 -2 -2 -2 -2 -2 -2 -2 -2 12 -9 13 -2 -2 -2 -2 -2 -2 -2 -2 -2 -2 -2 -2 03
02 -2 06 15 15 07 -2 06 15 15 15 07 -2 12 -9 13 -2 06 15 15 15 07 -2 06 15 15 07 -2 03
02 -2 16 14 07 13 -2 16 14 14 14 17 -2 16 14 17 -2 16 14 14 14 17 -2 12 06 14 17 -2 03
02 -2 -2 -3 12 13 -2 -2 -2 -2 -2 -2 -2 -2 -1 -2 -2 -2 -2 -2 -2 -2 -2 12 13 -3 -2 -2 03
20 15 07 -2 12 13 -2 06 07 -2 06 15 15 15 15 15 15 15 07 -2 06 07 -2 12 13 -2 06 15 21
30 14 17 -2 16 17 -2 13 12 -2 16 14 14 07 -9 06 14 14 17 -2 13 12 -2 16 17 -2 16 14 31
02 -2 -2 -2 -2 -2 -2 13 12 -2 -2 -2 -2 12 -9 13 -2 -2 -2 -2 13 12 -2 -2 -2 -2 -2 -2 03
02 -2 06 15 15 15 15 17 16 14 14 07 -2 12 -9 13 -2 06 15 15 17 16 15 15 15 15 07 -2 03
02 -2 16 14 14 14 14 14 14 14 14 17 -2 16 14 17 -2 16 14 14 14 14 14 14 14 14 17 -2 03
02 -4 -2 -2 -2 -2 -2 -2 -2 -2 -2 -2 -2 -2 -2 -2 -2 -2 -2 -2 -2 -2 -2 -2 -2 -2 -2 -5 03
10 05 05 05 05 05 05 05 05 05 05 05 05 05 05 05 05 05 05 05 05 05 05 05 05 05 05 05 11
-9 -9 -9 -9 -9 -9 -9 -9 -9 -9 -9 -9 -9 -9 -9 -9 -9 -9 -9 -9 -9 -9 -9 -9 -9 -9 -9 -9 -9
-9 -9 -9 -9 -9 -9 -9 -9 -9 -9 -9 -9 -9 -9 -9 -9 -9 -9 -9 -9 -9 -9 -9 -9 -9 -9 -9 -9 -9