-1 -1 -1 -1 -1 -1 -1 -1 -1 -1 -1 -1 -1 -1 -1 -1 -1 -1 -1 -1 -1 -1 -1 -1 -1 -1 -1 -1 -1
-1 -1 -1 -1 -1 -1 -1 -1 -1 -1 -1 -1 -1 -1 -1 -1 -1 -1 -1 -1 -1 -1 -1 -1 -1 -1 -1 -1 -1
-1 -1 -1 -1 -1 -1 -1 -1 -1 -1 -1 -1 -1 -1 -1 -1 -1 -1 -1 -1 -1 -1 -1 -1 -1 -1 -1 -1 -1
-1 -1 -1 -1 -1 -1 -1 -1 -1 -1 -1 -1 -1 -1 -1 -1 -1 -1 -1 -1 -1 -1 -1 -1 -1 -1 -1 -1 -1
00 04 04 04 04 04 04 04 04 04 04 04 04 08 24 09 04 04 04 04 04 04 04 04 04 04 04 04 01
02 -1 -1 -1 -1 -1 -1 -1 -1 -1 -1 -1 -1 12 -1 13 -1 -1 -1 -1 -1 -1 -1 -1 -1 -1 -1 -1 03
02 -1 06 15 15 07 -1 06 15 15 15 07 -1 12 -1 13 -1 06 15 15 15 07 -1 06 15 15 07 -1 03
02 -1 12 -1 -1 13 -1 12 -1 -1 -1 13 -1 12 -1 13 -1 12 -1 -1 -1 13 -1 12 -1 -1 13 -1 03
02 -1 16 14 14 17 -1 16 14 14 14 17 -1 16 14 17 -1 16 14 14 14 17 -1 16 14 14 17 -1 03
02 -1 -1 -1 -1 -1 -1 -1 -1 -1 -1 -1 -1 -1 -1 -1 -1 -1 -1 -1 -1 -1 -1 -1 -1 -1 -1 -1 03
02 -1 06 15 15 07 -1 06 07 -1 06 15 15 15 15 15 15 15 07 -1 06 07 -1 06 15 15 07 -1 03
02 -1 16 14 14 17 -1 12 13 -1 16 14 14 07 -1 06 14 14 17 -1 12 13 -1 16 14 14 17 -1 03
02 -1 -1 -1 -1 -1 -1 12 13 -1 -1 -1 -1 12 -1 13 -1 -1 -1 -1 12 13 -2 -1 -1 -1 -1 -1 03
10 05 05 05 05 23 -1 12 16 15 15 07 -1 12 -1 13 -1 06 15 15 17 13 -1 22 05 05 05 05 11
-1 -1 -1 -1 -1 02 -1 12 06 14 14 17 -1 16 14 17 -1 16 14 14 07 13 -3 03 -1 -1 -1 -1 -1
-1 -1 -1 -1 -1 02 -1 12 13 -1 -1 -1 -1 -1 -1 -1 -1 -1 -1 -1 12 13 -2 03 -1 -1 -1 -1 -1
-1 -1 -1 -1 -1 02 -1 12 13 -1 22 05 05 -1 -1 -1 05 05 23 -1 12 13 -2 03 -1 -1 -1 -1 -1
04 04 04 04 04 33 -1 16 17 -1 03 -1 -1 -1 -1 -1 -1 -1 02 -1 16 17 -2 32 04 04 04 04 04
-1 -1 -1 -1 -1 -1 -1 -1 -1 -1 03 -1 -1 -1 -1 -1 -1 -1 02 -1 -1 -1 -2 -1 -1 -1 -1 -1 -1
05 05 05 05 05 23 -1 06 07 -1 03 -1 -1 -1 -1 -1 -1 -1 02 -1 06 07 -2 22 05 05 05 05 05
-1 -1 -1 -1 -1 02 -1 12 13 -1 32 04 04 04 04 04 04 04 33 -1 12 13 -2 03 -1 -1 -1 -1 -1
-1 -1 -1 -1 -1 02 -1 12 13 -1 -1 -1 -1 -1 -1 -1 -1 -1 -1 -1 12 13 -2 03 -1 -1 -1 -1 -1
-1 -1 -1 -1 -1 02 -1 12 13 -1 06 15 15 15 15 15 15 15 07 -1 12 13 -3 03 -1 -1 -1 -1 -1
00 04 04 04 04 33 -1 16 17 -1 16 14 14 07 -1 06 14 14 17 -1 16 17 -2 32 04 04 04 04 01
02 -1 -1 -1 -1 -1 -1 -1 -1 -1 -1 -1 -1 12 -1 13 -1 -1 -1 -1 -1 -1 -1 -1 -1 -1 -1 -1 03
02 -1 06 15 15 07 -1 06 15 15 15 07 -1 12 -1 13 -1 06 15 15 15 07 -1 06 15 15 07 -1 03
02 -1 16 14 07 13 -1 16 14 14 14 17 -1 16 14 17 -1 16 14 14 14 17 -1 12 06 14 17 -1 03
02 -1 -1 -1 12 13 -2 -1 -2 -3 -1 -2 -1 -1 -1 -1 -1 -1 -1 -1 -1 -1 -1 12 13 -1 -1 -1 03
20 15 07 -1 12 13 -1 06 07 -1 06 15 15 15 15 15 15 15 07 -1 06 07 -1 12 13 -1 06 15 21
30 14 17 -1 16 17 -1 13 12 -1 16 14 14 07 -1 06 14 14 17 -1 13 12 -1 16 17 -1 16 14 31
02 -1 -1 -1 -1 -1 -1 13 12 -1 -2 -1 -1 12 -1 13 -1 -1 -1 -1 13 12 -1 -1 -1 -1 -1 -1 03
02 -1 06 15 15 15 15 17 16 14 14 07 -1 12 -1 13 -1 06 15 15 17 16 15 15 15 15 07 -1 03
02 -1 16 14 14 14 14 14 14 14 14 17 -1 16 14 17 -1 16 14 14 14 14 14 14 14 14 17 -1 03
02 -1 -1 -1 -1 -1 -1 -1 -1 -1 -1 -1 -1 -1 -1 -1 -1 -1 -1 -1 -1 -1 -1 -1 -1 -1 -1 -1 03
10 05 05 05 05 05 05 05 05 05 05 05 05 05 05 05 05 05 05 05 05 05 05 05 05 05 05 05 11
-1 -1 -1 -1 -1 -1 -1 -1 -1 -1 -1 -1 -1 -1 -1 -1 -1 -1 -1 -1 -1 -1 -1 -1 -1 -1 -1 -1 -1
-1 -1 -1 -1 -1 -1 -1 -1 -1 -1 -1 -1 -1 -1 -1 -1 -1 -1 -1 -1 -1 -1 -1 -1 -1 -1 -1 -1 -1
